#STORY=story_level1
^^^SETTINGS^^^
   *********************
  * T @       #         *
 *||||||    |||||||||||||*
*                         *
iw        m              *
 *    |||||||||||||||||||wi
 ***  |||||||||||||||||||*
 *           *   *       *
 *                       *
iw       *    w  *       *
 *************************

