#STORY=story_level1
^^^SETTINGS^^^
  *********************
 * T @       #         *
*||||||    |||||||||||||*
w                       *
*    |||||||||||||||||||w
***  |||||||||||||||||||*
*           *   *       *
*                       *
w       *       *       *
*************w***********

